R 820 560
R 43 54

NO ./textures/north.bmp
SO ./textures/south.bmp
WE ./textures/west.bmp
EA ./textures/east.bmp

S ./textures/sprite.bmp
F 200,100,0
C 255,255,255


111111111111
110002002011
100110010001
110001110101
110010011101
110000s11101
111110000001
111111000101
111111111111