R 1000 650

NO ./textures/eagle.xpm
SO ./textures/S.xpm
WE ./textures/W.xpm
EA ./textures/E.xpm

S ./textures/ruby.xpm
F 0,0,255
C 255,0,0

		111111111111
		100000000001
11111111100000000011111
10000001000000000010001
10000000000020000000001
11111001000000000010001
	1000000000111111111
	100000000001
	111110001111
		100001
		100001
		100001
		100001
		100001
	111111000111
	102000000001
	100111000111
	1001110001
	1001110001
	1111110001
			100011
			110011
	111111100011111111
	100000000000000011
	1000000000000000111111
	1000000000000000010001
	1000000000000000000001
	1000000000000000010001
	1000000000000000110001
	1000000000000000111111
	11111111001111111
				11001
				10001
				10001
				10001
				10001
				10001
				10001
				10001
				10001
				10001
				10001
				10001
			111110001111111
			100001000100001
			100000000000001
			100001000100001
			100001000100001
			111111000111111
			100001000100001
			100000000000201
			100001000100001
			111111000111111
			100000000000001
			100000000000001
			1000000N0000001
			111111111111111