R 1000 600

NO ./textures/eagle.xpm
SO ./textures/stone.xpm
WE ./textures/oak_planks.xpm
EA ./textures/bluestone.xpm

S ./textures/ruby.xpm
F 134,54,0
C 0,0,255

1111111111111111111111111
1000000000110000000000001
1000000000110000000000001
100000000011000000000000111111111
100000000000000000000000000200001
100000002000000000000000111111111
1000000000100011100000011
1000000000111111110000001
1001111111111111000000011
100000000W000000000000001
1000000000000000000000201
1000000000000000000000001
1111111111111111111111111
