R 1000 650

NO ./textures/eagle.xpm
SO ./textures/S.xpm
WE ./textures/W.xpm
EA ./textures/E.xpm

S ./textures/ruby.xpm
F 0,0,255
C 255,0,0

11111111111111111111111111111
10000000001100000000000000001
10110000011100000000000010001
10010200000000000000000010001
10110000011100000000000010001
10000000001100000111011110001
11110111111111011100000010001
11110111111111011101010010101
11000000110101011100000010001
10000000000000001100000010001
100000000000N0001101010010001
11000000110001011111002000001
11110111111101011111011110001
11111111111111111111111111001
11111111111111111111111111001
11111111111111111111111111001
11111111111111111111111111001
11111111111111111111111111001
11111111111111111111110000001
11111111111111111111000000001
		1111111111110000000011111111
			11111111100000011111111111111
			11110000000000000000000000001
			11000000000000000000000000001
			11000000000002000000000000001
			11000000000000000000000000001
			11111000111000000111111111001
			11000000000000000000200000001
			11111111111111111111111111111
