R 1000 650

NO ./textures/eagle.xpm
SO ./textures/S.xpm
WE ./textures/W.xpm
EA ./textures/E.xpm

S ./textures/ruby.xpm
F 0,0,255
C 255,0,0

111111111  111
100100001111011
120000000000001
11000000110111
100000001101
111111111101
121000000001
101111001101
1001110011111111111111111111
1000000000000000000000000001
1111111111111111111000111001
                111000110001
                110000000001
                100000000001
                100111111001
                100001111001
                111000000001
                111111000001
                100000111001
                1000N0000001
                100000000001
                111111111111
