R 820 560

NO ./textures/N.xpm
SO ./textures/S.xpm
WE ./textures/W.xpm
EA ./textures/E.xpm

S ./textures/ruby.xpm
F 178,100,0
C 154,134,43

111111111  111
100100001111011
120001000000001
1100N100110111
100000001101
111111111101
121000000001
101111001101
100111001111111111111111111
100000000000000000000000001
111111111111111111100011101
                11100011001
                11000000001
                10000000001
                10011111101
                10000111101
                11100000001
                11111100001
                10000011101
                10020000001
                10000000001
                11111111111
