R 820 560

NO ./textures/colorstone.bmp
SO ./textures/south.bmp
WE ./textures/bluestone.bmp
EA ./textures/oak_planks.bmp

S ./textures/stone.bmp
F 200,100,0
C 255,255,255

1111111
1000001
100N001
1000001
1111111
